,0,1,2,3,4,5,6
0,AJ네트웍스,3905,3485,-420,-10.76,4566482,17060552945
1,AK홀딩스,17400,17800,400,2.3,155652,2782151700
2,BGF,4170,4300,130,3.12,1734533,7571216080
3,BGF리테일,128000,125000,-3000,-2.34,414365,54495268000
4,BNK금융지주,5460,5600,140,2.56,11337546,64524109345
5,BYC,221000,243500,22500,10.18,7732,1808175500
6,BYC우,119000,123000,4000,3.36,1197,146777000
7,CJ,80800,78500,-2300,-2.85,369287,29506163900
8,CJ대한통운,181500,160500,-21000,-11.57,2373420,398791862500
9,CJ씨푸드,4815,4435,-380,-7.89,127937256,714690889265
10,CJ씨푸드1우,45800,42300,-3500,-7.64,34891,1653427250
11,CJ우,47900,47800,-100,-0.21,20936,1003737900
12,CJ제일제당,385500,363000,-22500,-5.84,261978,98941197500
13,CS홀딩스,54300,54900,600,1.1,45235,2545275700
14,DB,696,684,-12,-1.72,2712235,1881689665
15,DB금융투자,3925,3970,45,1.15,1163185,4660338500
16,DB손해보험,45050,46050,1000,2.22,928609,43240559000
17,DB하이텍,35300,31550,-3750,-10.62,3954349,130175705800
18,DB하이텍1우,127000,111500,-15500,-12.2,25467,3102466000
19,DGB금융지주,6250,6580,330,5.28,10421273,69401843790
20,DI동일,85000,84900,-100,-0.12,32340,2767864700
21,DRB동일,6680,6420,-260,-3.89,234694,1562149080
22,DSR,6100,5510,-590,-9.67,1106241,6443040350
23,DSR제강,4640,4400,-240,-5.17,486418,2228319230
24,E1,48200,46550,-1650,-3.42,152821,7358601450
25,GKL,12400,12350,-50,-0.4,2476046,31303230100
26,GS,34200,33600,-600,-1.75,1851557,64166111100
27,GS건설,26450,28000,1550,5.86,5071428,140382908400
28,GS글로벌,1730,1690,-40,-2.31,1099423,1890468245
29,GS리테일,35950,34300,-1650,-4.59,2017231,71990291500
30,GS우,29150,29300,150,0.51,35315,1035123450
31,HDC,10200,10250,50,0.49,1153379,11902973050
32,HDC현대EP,6240,5570,-670,-10.74,2075079,12340656040
33,HDC현대산업개발,20400,19950,-450,-2.21,1908581,38560716250
34,HMM,7000,8860,1860,26.57,63944392,525774323030
35,HSD엔진,4805,4690,-115,-2.39,1672698,8238633855
36,IHQ,1380,1315,-65,-4.71,2094578,2802867405
37,JB금융지주,4810,5010,200,4.16,4184667,20962983245
38,JW생명과학,18600,18100,-500,-2.69,625325,11585984350
39,JW중외제약,32400,30550,-1850,-5.71,819093,26219254050
40,JW중외제약2우B,67100,65300,-1800,-2.68,11429,771888700
41,JW중외제약우,54600,48850,-5750,-10.53,12757,660629000
42,JW홀딩스,5760,5520,-240,-4.17,8351967,50270352490
43,KB금융,40700,41750,1050,2.58,13493067,565019485938
44,KCC,161500,162000,500,0.31,568145,92308439000
45,KCTC,2550,2470,-80,-3.14,619239,1548060540
46,KC그린홀딩스,4250,4170,-80,-1.88,1430367,6081753005
47,KC코트렐,9550,7700,-1850,-19.37,14112283,118491826460
48,KEC,2740,1980,-760,-27.74,323527065,741456931950
49,KG동부제철,8270,8040,-230,-2.78,606574,4906431690
50,KG동부제철우,131000,127500,-3500,-2.67,3653,479464500
51,KG케미칼,18800,18300,-500,-2.66,492438,9207438750
52,KISCO홀딩스,11700,11750,50,0.43,27323,320889500
53,KPX케미칼,49600,48950,-650,-1.31,84604,4165217250
54,KPX홀딩스,49150,46000,-3150,-6.41,860753,41890579800
55,KR모터스,1070,923,-147,-13.74,47222700,48396238775
56,KSS해운,9660,9420,-240,-2.48,369650,3597813550
57,KT,23100,22950,-150,-0.65,4851568,111677896063
58,KTB투자증권,2580,2605,25,0.97,1025840,2722924925
59,KTcs,2040,2035,-5,-0.25,1321136,2697077930
60,KTis,2430,2420,-10,-0.41,848608,2080137120
61,LF,14300,15300,1000,6.99,1910952,29061864200
62,LG,71500,70700,-800,-1.12,1176798,84471664944
63,LG디스플레이,15750,14800,-950,-6.03,11907018,183826588900
64,LG생활건강,1562000,1543000,-19000,-1.22,161632,248154837697
65,LG생활건강우,710000,715000,5000,0.7,119057,77047214000
66,LG우,53000,53500,500,0.94,54715,2921882500
67,LG유플러스,11650,11500,-150,-1.29,7107101,83008147600
68,LG이노텍,164000,155000,-9000,-5.49,701523,111379767500
69,LG전자,89100,89400,300,0.34,2974400,265654006500
70,LG전자우,33300,33100,-200,-0.6,343582,11368140050
71,LG헬로비전,3945,3835,-110,-2.79,853367,3289163275
72,LG화학,615000,632000,17000,2.76,2168777,1368694502000
73,LG화학우,320000,321500,1500,0.47,163925,52880886321
74,LIG넥스원,30400,28900,-1500,-4.93,421269,12445444800
75,LS,55700,55400,-300,-0.54,1254008,70572321900
76,LS네트웍스,2100,2155,55,2.62,238907,510628240
77,LS전선아시아,7360,7260,-100,-1.36,1100086,8290238400
78,MH에탄올,7750,7340,-410,-5.29,602541,4773634680
79,NAVER,286000,283500,-2500,-0.87,4465045,1287392453500
80,NHN,73000,70400,-2600,-3.56,291223,21196849500
81,NH투자증권,9290,9450,160,1.72,11798635,114161878420
82,NH투자증권우,8040,8140,100,1.24,985955,8076353650
83,NH프라임리츠,4275,4510,235,5.5,806490,3569818490
84,NICE,18200,18350,150,0.82,305625,5602114650
85,NI스틸,2270,2220,-50,-2.2,7535045,18102231475
86,NPC,3075,3010,-65,-2.11,335610,1020407255
87,NPC우,2215,2265,50,2.26,28482,64488340
88,OCI,59500,60300,800,1.34,1776451,109371492000
89,POSCO,208500,220000,11500,5.52,3078694,661520009556
90,S-Oil,57900,57000,-900,-1.55,1464879,84415521000
91,S-Oil우,32900,31900,-1000,-3.04,49150,1591232900
92,SBS,15450,16000,550,3.56,437336,6944497100
93,SG세계물산,600,591,-9,-1.5,8068843,4815670091
94,SH에너지화학,800,786,-14,-1.75,3166356,2547465740
95,SIMPAC,2340,2310,-30,-1.28,224937,522776860
96,SJM,2795,3015,220,7.87,893412,2686057690
97,SJM홀딩스,2735,2810,75,2.74,161127,450375890
98,SK,199000,193000,-6000,-3.02,776125,153272738000
99,SKC,72900,71500,-1400,-1.92,1693695,123694268100
100,SK가스,113500,111500,-2000,-1.76,247861,27794402000
101,SK네트웍스,4620,4585,-35,-0.76,2195710,10172399170
102,SK네트웍스우,116000,112500,-3500,-3.02,3494,407373000
103,SK디스커버리,61900,63000,1100,1.78,759331,47062145300
104,SK디스커버리우,52000,52500,500,0.96,402672,21855535000
105,SK디앤디,43400,42500,-900,-2.07,575935,24978292700
106,SK렌터카,8720,8440,-280,-3.21,317660,2732147500
107,SK바이오팜,154500,156500,2000,1.29,1560800,247267344500
108,SK우,197000,194500,-2500,-1.27,24978,4923351500
109,SK이노베이션,136500,131500,-5000,-3.66,1990397,268947915000
110,SK이노베이션우,115000,110500,-4500,-3.91,76119,8455525000
111,SK증권,705,700,-5,-0.71,40486400,29418875240
112,SK증권우,5350,5440,90,1.68,18920763,128089400865
113,SK케미칼,339000,341500,2500,0.74,2092134,676781495500
114,SK케미칼우,171500,178000,6500,3.79,332980,57373052500
115,SK텔레콤,232500,232500,0,0.0,1084843,254848217500
116,SK하이닉스,86700,82600,-4100,-4.73,20680748,1743008586636
117,SPC삼립,62400,69100,6700,10.74,284124,19381954800
118,STX,5500,5480,-20,-0.36,850246,4943432720
119,STX엔진,6310,6200,-110,-1.74,186014,1192392420
120,STX중공업,3995,3650,-345,-8.64,1771796,6923468330
121,TBH글로벌,1905,1805,-100,-5.25,1168918,2183204710
122,TCC스틸,3720,3250,-470,-12.63,7608645,27763924780
123,WISCOM,2275,2310,35,1.54,873829,2128539900
124,가온전선,22300,20850,-1450,-6.5,75688,1626787900
125,강남제비스코,15600,16300,700,4.49,113583,1820876350
126,강원랜드,22400,22550,150,0.67,3178086,72236087350
127,갤럭시아에스엠,1450,1410,-40,-2.76,1337259,1949504575
128,경농,12450,11200,-1250,-10.04,389743,4633945500
129,경동나비엔,54000,52300,-1700,-3.15,199142,10674277200
130,경동도시가스,20400,19000,-1400,-6.86,237055,4662048350
131,경동인베스트,27050,27500,450,1.66,22417,616254500
132,경방,10500,10900,400,3.81,162583,1763660500
133,경보제약,10300,9400,-900,-8.74,399315,3967391630
134,경인양행,6870,6370,-500,-7.28,1673621,11163916030
135,경인전자,21550,23050,1500,6.96,295614,7840559850
136,계룡건설,22500,20450,-2050,-9.11,437038,9247067950
137,계양전기,3150,2930,-220,-6.98,861132,2625323645
138,계양전기우,8690,8840,150,1.73,376042,3373856650
139,고려산업,3610,3715,105,2.91,10422676,40407075295
140,고려아연,374000,378000,4000,1.07,349043,132798544500
141,고려제강,13800,13900,100,0.72,84026,1164948400
142,광동제약,10100,9250,-850,-8.42,4288320,42363190460
143,광명전기,2160,1970,-190,-8.8,3503246,7189831455
144,광전자,2300,2325,25,1.09,66257183,181302216250
145,광주신세계,162000,154000,-8000,-4.94,17719,2791043500
146,교보증권,6540,6720,180,2.75,1067108,7298020850
147,국도화학,46950,43400,-3550,-7.56,56563,2536378950
148,국동,3930,3450,-480,-12.21,4593407,17386816330
149,국보,2085,2035,-50,-2.4,5116270,10731596330
150,국제약품,9730,8930,-800,-8.22,1747004,16549970650
151,그린케미칼,3985,3875,-110,-2.76,246271,968359925
152,극동유화,3185,3210,25,0.78,3141375,10496434660
153,금강공업,4485,4295,-190,-4.24,585398,2540017740
154,금강공업우,17400,16600,-800,-4.6,1021641,18349838950
155,금비,55700,56100,400,0.72,29411,1698914300
156,금양,5020,4800,-220,-4.38,1104968,5493190580
157,금호석유,132000,134500,2500,1.89,1595136,219517182500
158,금호석유우,55500,53500,-2000,-3.6,203195,11242548000
159,금호에이치티,3950,2625,-1325,-33.54,114491292,400934026345
160,금호전기,4550,4445,-105,-2.31,871000,4013487535
161,금호타이어,3430,3690,260,7.58,3797834,13877400410
162,기신정기,3730,3635,-95,-2.55,985073,3664796300
163,기업은행,8220,8340,120,1.46,17318654,146777644690
164,까뮤이앤씨,1985,1910,-75,-3.78,45951398,91598612665
165,깨끗한나라,4490,4325,-165,-3.67,1314470,5948700595
166,깨끗한나라우,23200,23300,100,0.43,12375,302619150
167,남광토건,9970,9790,-180,-1.81,127443,1267121720
168,남선알미늄,4945,3930,-1015,-20.53,32584752,140410684285
169,남선알미우,56400,46800,-9600,-17.02,64204,3248136000
170,남성,3575,3170,-405,-11.33,20614977,70651354005
171,남양유업,261500,259000,-2500,-0.96,6697,1749099000
172,남양유업우,147000,136500,-10500,-7.14,1667,235353500
173,남해화학,8180,7960,-220,-2.69,763385,6208987080
174,넥센,4000,4025,25,0.63,254949,1021608350
175,넥센우,3060,3030,-30,-0.98,212650,659468185
176,넥센타이어,5370,5370,0,0.0,1225988,6633017420
177,넥센타이어1우B,2325,2340,15,0.65,91420,214445650
178,넥스트사이언스,5850,5650,-200,-3.42,2058713,12339265780
179,넷마블,133000,122500,-10500,-7.89,2614624,335831759500
180,노루페인트,7060,7120,60,0.85,297516,2112569250
181,노루페인트우,13700,13450,-250,-1.82,26337,361375650
182,노루홀딩스,9130,9180,50,0.55,31187,285682090
183,노루홀딩스우,18050,18000,-50,-0.28,6647,121129450
184,녹십자,222500,256000,33500,15.06,5254500,1345583544500
185,녹십자홀딩스,22100,22300,200,0.9,3134712,72722675950
186,녹십자홀딩스2우,129000,159000,30000,23.26,1383648,240110462000
187,농심,299000,287000,-12000,-4.01,138753,40876575500
188,농심홀딩스,73800,73500,-300,-0.41,16956,1245210100
189,다스코,5680,5550,-130,-2.29,473533,2572525260
190,다우기술,19800,19250,-550,-2.78,1221430,24018033900
191,대교,3915,3980,65,1.66,3509322,15392660180
192,대교우B,2530,2530,0,0.0,1402466,3680605120
193,대구백화점,8150,9190,1040,12.76,234248,1959822750
194,대덕,6200,6240,40,0.65,817470,5152531210
195,대덕1우,7220,14350,7130,98.75,4194438,49815013030
196,대덕전자,10200,9970,-230,-2.25,2449848,25372523130
197,대덕전자1우,7250,8770,1520,20.97,11196388,101820537990
198,대동전자,4340,4485,145,3.34,33534,147754475
199,대림통상,4185,4120,-65,-1.55,14942,61534160
200,대상,25200,24900,-300,-1.19,672639,16917858050
201,대상우,17250,16900,-350,-2.03,29610,511906800
202,대상홀딩스,9620,9870,250,2.6,991601,9989328120
203,대상홀딩스우,8330,8850,520,6.24,95503,830302700
204,대성산업,3210,2955,-255,-7.94,556590,1702655110
205,대성에너지,5640,5310,-330,-5.85,388361,2111889940
206,대성홀딩스,22450,22400,-50,-0.22,772306,17508901200
207,대신증권,12250,13900,1650,13.47,1510404,20350852350
208,대신증권2우B,9520,9740,220,2.31,491335,4855944310
209,대신증권우,10000,10150,150,1.5,725569,7366131400
210,대양금속,3390,3125,-265,-7.82,1482837,4853281025
211,대영포장,1105,1090,-15,-1.36,18951414,20865074065
212,대우건설,2985,3020,35,1.17,17141034,52758119120
213,대우부품,2785,2640,-145,-5.21,6327031,17321040690
214,대우조선해양,23000,22250,-750,-3.26,850414,19287832250
215,대웅,25600,22500,-3100,-12.11,1792514,43319443500
216,대웅제약,102000,90400,-11600,-11.37,510014,50197910700
217,대원강업,4065,3925,-140,-3.44,2518272,10071851900
218,대원전선,989,955,-34,-3.44,3305574,3198641485
219,대원전선우,3625,3830,205,5.66,1506218,5912440360
220,대원제약,19250,18100,-1150,-5.97,1096047,20453240400
221,대원화성,1585,1510,-75,-4.73,335052,514323015
222,대유에이텍,805,786,-19,-2.36,1245794,998332389
223,대유플러스,813,771,-42,-5.17,4720505,3738314704
224,대창,1150,1165,15,1.3,58336951,72601435345
225,대창단조,33600,31950,-1650,-4.91,92509,3007802400
226,대한방직,33900,33700,-200,-0.59,52437,1778368000
227,대한유화,181000,187000,6000,3.31,432621,82568124500
228,대한전선,871,872,1,0.11,47661789,42001000655
229,대한제강,7020,6700,-320,-4.56,408084,2831131340
230,대한제당,18850,18300,-550,-2.92,48672,909891200
231,대한제당우,13400,13450,50,0.37,15716,215339850
232,대한제분,152000,143000,-9000,-5.92,21399,3157410000
233,대한항공,20550,20750,200,0.97,9484325,199062866400
234,대한항공우,24300,24100,-200,-0.82,174816,4233362150
235,대한해운,1630,1670,40,2.45,12864346,21784955555
236,대한화섬,81500,82000,500,0.61,1859,151817400
237,대현,1805,1780,-25,-1.39,1731794,3175717240
238,대호에이엘,2090,1950,-140,-6.7,1417965,2849768310
239,더블유게임즈,67600,66300,-1300,-1.92,391876,26445617700
240,더존비즈온,107500,99000,-8500,-7.91,548354,56642464196
241,덕성,4890,4580,-310,-6.34,25552477,132281896775
242,덕성우,9570,9290,-280,-2.93,2690344,27180099980
243,덕양산업,1890,1820,-70,-3.7,1445320,2657814530
244,덴티움,36850,38400,1550,4.21,611715,24014714650
245,도화엔지니어링,7600,7450,-150,-1.97,365794,2750200950
246,동국제강,6580,6500,-80,-1.22,3267097,21659179420
247,동남합성,37750,38950,1200,3.18,18138,698616700
248,동방,1800,1885,85,4.72,4243722,7975411060
249,동방아그로,6250,6230,-20,-0.32,37989,236237540
250,동부건설,11300,11200,-100,-0.88,354515,4041567550
251,동부건설우,27400,27350,-50,-0.18,15085,417239550
252,동서,29400,29350,-50,-0.17,895204,26352092950
253,동성제약,11750,11000,-750,-6.38,551701,6308010550
254,동아쏘시오홀딩스,115500,111000,-4500,-3.9,219310,25606353500
255,동아에스티,87600,85700,-1900,-2.17,136289,12016333600
256,동아지질,14750,14400,-350,-2.37,325847,4836291600
257,동아타이어,9060,9080,20,0.22,108103,992504150
258,동양,1150,1110,-40,-3.48,9728027,11421240505
259,동양2우B,13650,13700,50,0.37,36324,501025550
260,동양3우B,30050,28650,-1400,-4.66,46165,1455864650
261,동양고속,26100,26200,100,0.38,32236,843912150
262,동양생명,3190,3260,70,2.19,2134577,7158378985
263,동양우,7580,8350,770,10.16,297496,2420750230
264,동양철관,1045,1015,-30,-2.87,5039075,5229276130
265,동양피스톤,6050,5620,-430,-7.11,1055269,6209538190
266,동원금속,697,699,2,0.29,673560,467213996
267,동원산업,222000,203000,-19000,-8.56,24618,5182426000
268,동원수산,8760,8780,20,0.23,3655417,34572074490
269,동원시스템즈,22750,22850,100,0.44,98744,2269328450
270,동원시스템즈우,28300,28100,-200,-0.71,7345,207561850
271,동일고무벨트,9340,8720,-620,-6.64,457844,4196101470
272,동일산업,68500,68400,-100,-0.15,7422,508146400
273,동일제강,2350,2370,20,0.85,480235,1139864035
274,동화약품,21300,17500,-3800,-17.84,4528619,85189220600
275,두산,45450,46050,600,1.32,373152,17488194900
276,두산2우B,83000,80300,-2700,-3.25,15969,1318886700
277,두산밥캣,29700,29150,-550,-1.85,5636374,175266322350
278,두산우,39550,39300,-250,-0.63,122740,4905661200
279,두산중공업,13350,13400,50,0.37,27639421,370664471250
280,두산퓨얼셀,46000,39550,-6450,-14.02,10386075,456510527200
281,두산퓨얼셀1우,18050,15300,-2750,-15.24,1803314,30480689450
282,두산퓨얼셀2우B,24700,22950,-1750,-7.09,400830,10127127400
283,두올,3530,3305,-225,-6.37,3301288,11463930035
284,드림텍,13250,12000,-1250,-9.43,4867541,61346263850
285,디씨엠,10800,10900,100,0.93,19027,206795900
286,디아이,3995,3860,-135,-3.38,674271,2694729160
287,디아이씨,1445,1370,-75,-5.19,469397,656058480
288,디와이,4315,4110,-205,-4.75,259751,1098201675
289,디와이파워,12250,10900,-1350,-11.02,964572,11211046250
290,디티알오토모티브,22700,22100,-600,-2.64,167096,3705571450
291,락앤락,10600,10350,-250,-2.36,437578,4587010550
292,롯데관광개발,15150,14950,-200,-1.32,850284,12967346350
293,롯데리츠,5270,5450,180,3.42,2209859,11845865670
294,롯데손해보험,1625,1675,50,3.08,54454795,103314347870
295,롯데쇼핑,95500,86000,-9500,-9.95,963663,87560543800
296,롯데정밀화학,53900,49050,-4850,-9.0,695514,35266055050
297,롯데정보통신,33750,34500,750,2.22,182193,6310618800
298,롯데제과,100000,98900,-1100,-1.1,33313,3305635400
299,롯데지주,29750,29400,-350,-1.18,754218,22424182500
300,롯데지주우,61700,63200,1500,2.43,32735,2060113900
301,롯데칠성,88500,88100,-400,-0.45,146465,12947509600
302,롯데칠성우,57200,57400,200,0.35,7710,441636900
303,롯데케미칼,223000,231000,8000,3.59,2165650,518725304500
304,롯데푸드,308500,310000,1500,0.49,12653,3921591500
305,롯데하이마트,31950,31350,-600,-1.88,707009,22694730400
306,마니커,682,678,-4,-0.59,22206824,15558943745
307,만도,34300,35500,1200,3.5,4378438,152978060700
308,만호제강,15100,14500,-600,-3.97,12630,185722050
309,맥쿼리인프라,11000,11200,200,1.82,5105997,56390281400
310,맵스리얼티1,4005,4070,65,1.62,208720,845562315
311,메리츠금융지주,9290,9470,180,1.94,646375,6197877120
312,메리츠증권,3270,3335,65,1.99,17553090,59502597320
313,메리츠화재,14200,14650,450,3.17,2843359,42614940800
314,메타랩스,1200,1130,-70,-5.83,1391148,1593335870
315,명문제약,6200,5960,-240,-3.87,19990445,130199748690
316,모나리자,5140,5090,-50,-0.97,18735627,104803316540
317,모나미,6160,6030,-130,-2.11,11752763,75299358000
318,모두투어리츠,3400,3055,-345,-10.15,153482,475500235
319,모토닉,11500,11050,-450,-3.91,832645,9505774050
320,무림페이퍼,2390,2395,5,0.21,457541,1096644940
321,무학,6600,6630,30,0.45,197806,1321989300
322,문배철강,2680,2560,-120,-4.48,21849993,65869673730
323,미래산업,3150,2960,-190,-6.03,554439,1688725885
324,미래아이앤지,347,345,-2,-0.58,2843210,984756267
325,미래에셋맵스리츠,4880,5010,130,2.66,649573,3233831035
326,미래에셋생명,3780,3890,110,2.91,452248,1788675820
327,미원상사,98800,98200,-600,-0.61,19853,1945763800
328,미원에스씨,100500,100500,0,0.0,52318,5277826500
329,미원홀딩스,58200,62900,4700,8.08,29673,1802719800
330,미원화학,55700,56200,500,0.9,9108,509955000
331,미창석유,61200,62200,1000,1.63,1750,107331300
332,바다로19호,2540,2545,5,0.2,36694,93292155
333,방림,1905,1805,-100,-5.25,639811,1210903400
334,백광산업,3305,3135,-170,-5.14,3035091,9966371280
335,백산,4335,4560,225,5.19,549648,2472843940
336,범양건영,5390,4645,-745,-13.82,3929074,20235915140
337,베트남개발1,278,302,24,8.63,14435628,4456009059
338,벽산,1925,1910,-15,-0.78,6320543,12800036630
339,보락,2430,2225,-205,-8.44,18575045,44532535375
340,보령제약,15300,14300,-1000,-6.54,1384475,20466493850
341,보해양조,849,805,-44,-5.18,6291545,5195050929
342,부광약품,26700,23850,-2850,-10.67,3951551,99672331200
343,부국증권,20350,21200,850,4.18,131701,2929546900
344,부국증권우,19350,20250,900,4.65,19319,385470050
345,부국철강,4975,4415,-560,-11.26,2745677,13444499595
346,부산산업,116500,110500,-6000,-5.15,41356,4750223500
347,부산주공,698,672,-26,-3.72,13274122,9396760607
348,비비안,3620,3195,-425,-11.74,3480423,11869780445
349,비상교육,6660,6400,-260,-3.9,93807,604751240
350,비케이탑스,7330,6300,-1030,-14.05,1779244,12056311200
351,빙그레,56000,55100,-900,-1.61,105113,5885708600
352,사조대림,14000,13750,-250,-1.79,329570,4769118300
353,사조동아원,870,835,-35,-4.02,2385341,2069311269
354,사조산업,29400,29000,-400,-1.36,137816,4154337350
355,사조씨푸드,4790,5560,770,16.08,78428205,534427435275
356,사조오양,9190,8700,-490,-5.33,6014957,59643859080
357,삼부토건,2290,3820,1530,66.81,168443940,558151391680
358,삼성SDI,413000,430000,17000,4.12,1466850,624070372500
359,삼성SDI우,240500,240000,-500,-0.21,56482,13626983000
360,삼성공조,6480,6130,-350,-5.4,72420,460312330
361,삼성물산,103000,115500,12500,12.14,13347411,1591516635158
362,삼성물산우B,96000,131000,35000,36.46,1890678,250221049500
363,삼성바이오로직스,686000,635000,-51000,-7.43,829638,539799919000
364,삼성생명,60500,66400,5900,9.75,8121399,539538631200
365,삼성에스디에스,174000,181000,7000,4.02,1950861,354484297500
366,삼성엔지니어링,11000,10550,-450,-4.09,5211449,56868704900
367,삼성전기,140000,141000,1000,0.71,2217002,310231004500
368,삼성전기우,62100,62300,200,0.32,135623,8459435300
369,삼성전자,60000,59800,-200,-0.33,89174527,5385703981117
370,삼성전자우,53000,53400,400,0.75,11289947,602408966042
371,삼성제약,3720,3430,-290,-7.8,2477713,8945347870
372,삼성중공업,5220,5100,-120,-2.3,9739002,50321299000
373,삼성중공우,345000,327500,-17500,-5.07,8063,2740783000
374,삼성증권,32900,32400,-500,-1.52,3172837,106281212000
375,삼성출판사,21300,22200,900,4.23,4350836,99336023150
376,삼성카드,29250,29700,450,1.54,991394,29579440350
377,삼성화재,187000,191500,4500,2.41,910074,174680188500
378,삼성화재우,141000,150000,9000,6.38,106056,15765078500
379,삼아알미늄,7920,7990,70,0.88,13420140,125943800720
380,삼양사,51600,48600,-3000,-5.81,70528,3544886350
381,삼양사우,46000,42800,-3200,-6.96,3301,145716650
382,삼양식품,100500,97400,-3100,-3.08,220600,21832073700
383,삼양통상,62200,63400,1200,1.93,29011,1811085800
384,삼양패키징,20100,19950,-150,-0.75,104277,2082599250
385,삼양홀딩스,62000,62000,0,0.0,73635,4575919400
386,삼양홀딩스우,48300,47500,-800,-1.66,1504,72346700
387,삼영무역,13950,14050,100,0.72,408612,5683360000
388,삼영전자,8010,7840,-170,-2.12,162774,1295381150
389,삼영화학,2220,2175,-45,-2.03,1242904,2810282105
390,삼원강재,2430,2375,-55,-2.26,129215,308213320
391,삼익THK,10600,10200,-400,-3.77,344104,3529748100
392,삼익악기,1360,1345,-15,-1.1,984060,1343535300
393,삼일씨엔에스,10750,9860,-890,-8.28,407178,4209530180
394,삼일제약,22500,20350,-2150,-9.56,352159,7610259250
395,삼정펄프,28100,28500,400,1.42,2576,72741200
396,삼진제약,27700,26200,-1500,-5.42,537411,14305075300
397,삼천리,80500,78400,-2100,-2.61,39489,3154519300
398,삼호개발,4060,4000,-60,-1.48,305183,1229690705
399,삼화왕관,39000,38350,-650,-1.67,21321,825669050
400,삼화전기,18400,18000,-400,-2.17,198805,3596197200
401,삼화전자,3090,3035,-55,-1.78,263889,803758940
402,삼화콘덴서,54300,50600,-3700,-6.81,478156,24896023450
403,삼화페인트,4910,4880,-30,-0.61,67156,328530465
404,상상인증권,1000,1020,20,2.0,750450,785089441
405,상신브레이크,2600,2605,5,0.19,682122,1785658885
406,새론오토모티브,4055,4080,25,0.62,63742,256817085
407,샘표,47600,43900,-3700,-7.77,34783,1589323300
408,샘표식품,45300,43100,-2200,-4.86,48676,2147060300
409,서연,8450,8990,540,6.39,40607268,384485216760
410,서연이화,4075,4395,320,7.85,5065084,22668475790
411,서울가스,76800,81000,4200,5.47,31483,2436110500
412,서울식품,150,150,0,0.0,23169233,3524610676
413,서울식품우,5280,5430,150,2.84,431287,2341571240
414,서원,3265,2780,-485,-14.85,6925339,21125590425
415,서흥,55800,50200,-5600,-10.04,176593,9286114800
416,선도전기,2665,2605,-60,-2.25,493471,1303315330
417,선진,9960,9930,-30,-0.3,543985,5460238990
418,성문전자,2060,1880,-180,-8.74,878303,1724887450
419,성문전자우,12950,14900,1950,15.06,832842,12339691750
420,성보화학,4205,4070,-135,-3.21,71095,292178990
421,성신양회,6900,6690,-210,-3.04,360929,2453058520
422,성신양회우,17500,16900,-600,-3.43,631144,11453028000
423,성안,357,352,-5,-1.4,552267,196113077
424,성창기업지주,1730,1765,35,2.02,82590552,169258761130
425,세기상사,61600,61600,0,0.0,0,0
426,세방,9270,9220,-50,-0.54,514139,4732363190
427,세방우,5980,5970,-10,-0.17,4459,26665990
428,세방전지,27850,27500,-350,-1.26,89815,2506738750
429,세아베스틸,9980,9730,-250,-2.51,638881,6356464900
430,세아제강,77900,82200,4300,5.52,211602,18165157300
431,세아제강지주,44250,45800,1550,3.5,63068,2914597900
432,세아특수강,10900,11200,300,2.75,60324,674376050
433,세아홀딩스,72000,71300,-700,-0.97,1709,121939500
434,세우글로벌,3140,2885,-255,-8.12,10336816,30587914540
435,세원정공,8090,8090,0,0.0,0,0
436,세종공업,8600,7980,-620,-7.21,2382894,19574250500
437,세진중공업,8850,8860,10,0.11,4140873,37666926240
438,세하,1700,1640,-60,-3.53,2595783,4360148795
439,센트랄모텍,20200,18800,-1400,-6.93,300434,5872764150
440,센트럴인사이트,7000,7000,0,0.0,0,0
441,셀트리온,255500,239000,-16500,-6.46,5029323,1215542429500
442,송원산업,14250,14450,200,1.4,2540714,37852092200
443,수산중공업,1855,1970,115,6.2,177373530,392741788650
444,스카이라이프,9380,9600,220,2.35,863904,8282784630
445,시디즈,58000,54000,-4000,-6.9,18070,998219200
446,신대양제지,54800,52600,-2200,-4.01,56729,3050062700
447,신도리코,22650,22250,-400,-1.77,84399,1888948950
448,신라교역,9460,9290,-170,-1.8,114247,1073454960
449,신성이엔지,2985,2715,-270,-9.05,92540384,277435165925
450,신성통상,1740,1835,95,5.46,48324663,88293374260
451,신세계,225000,212000,-13000,-5.78,616893,136029567500
452,신세계건설,21800,22150,350,1.61,37742,822964150
453,신세계인터내셔날,149000,144000,-5000,-3.36,190772,28416030000
454,신세계푸드,53800,52400,-1400,-2.6,28512,1505789100
455,신송홀딩스,3500,3410,-90,-2.57,52583,180760570
456,신영와코루,93400,102000,8600,9.21,3459,343172100
457,신영증권,45900,46150,250,0.54,41597,1927353950
458,신영증권우,46200,46400,200,0.43,6505,303603300
459,신원,1370,1300,-70,-5.11,1665701,2227045760
460,신원우,46750,45300,-1450,-3.1,9224,419408350
461,신일전자,1770,1780,10,0.56,6970578,12360822740
462,신풍제약,128500,127000,-1500,-1.17,10572051,1426413507500
463,신풍제약우,149500,141500,-8000,-5.35,253444,38496409500
464,신풍제지,2470,2315,-155,-6.28,10051149,25664171575
465,신한알파리츠,6860,7120,260,3.79,748664,5297128080
466,신한지주,29000,30200,1200,4.14,25700022,776972376700
467,신흥,9140,9420,280,3.06,22072,205427770
468,쌍방울,615,614,-1,-0.16,18181088,11415350326
469,쌍용차,4530,4230,-300,-6.62,7634368,32660383855
470,써니전자,4630,4175,-455,-9.83,13419513,59592346910
471,쎌마테라퓨틱스,7780,7100,-680,-8.74,912012,6795572650
472,씨아이테크,896,960,64,7.14,825470,762209634
473,씨에스윈드,99100,96300,-2800,-2.83,1624344,160674929900
474,아남전자,1835,2370,535,29.16,172092038,405580917370
475,아모레G,49050,45800,-3250,-6.63,533064,25292687700
476,아모레G우,20300,19500,-800,-3.94,119273,2377649900
477,아모레퍼시픽,170000,161000,-9000,-5.29,1184305,195944614917
478,아모레퍼시픽우,56600,53300,-3300,-5.83,210375,11594447100
479,아세아,82200,80300,-1900,-2.31,9749,787475900
480,아세아시멘트,57600,57700,100,0.17,50758,2948685400
481,아세아제지,31150,30400,-750,-2.41,589259,18136725850
482,아시아나IDT,19450,18200,-1250,-6.43,366800,6962181550
483,아시아나항공,4200,3755,-445,-10.6,22785860,88149693880
484,아이마켓코리아,8170,8480,310,3.79,1292896,11092579640
485,아이에스동서,40450,38900,-1550,-3.83,312889,12375207200
486,알루코,3990,4015,25,0.63,57680930,245620168380
487,애경산업,20900,21950,1050,5.02,665682,14503382350
488,에넥스,992,963,-29,-2.92,1256707,1235684177
489,에스엘,14700,15600,900,6.12,1816486,27981709600
490,에스원,86100,83100,-3000,-3.48,296395,25117949000
491,에쓰씨엔지니어링,1385,1390,5,0.36,410262,562325325
492,에어부산,3265,3280,15,0.46,1214567,4125688640
493,에이리츠,8180,8560,380,4.65,149539,1233594730
494,에이블씨엔씨,7560,7250,-310,-4.1,204582,1520868570
495,에이엔피,165,1405,1240,751.52,19819598,32882527065
496,에이프로젠제약,1275,1245,-30,-2.35,15469006,19734913320
497,엔씨소프트,771000,782000,11000,1.43,552634,440764883000
498,엔에스쇼핑,11900,11750,-150,-1.26,581441,6859678050
499,엔케이,1075,1045,-30,-2.79,2978243,3077618808
500,엘브이엠씨홀딩스,3510,3200,-310,-8.83,10499296,33778095740
501,영보화학,3750,3535,-215,-5.73,619056,2240192425
502,영원무역,28600,29150,550,1.92,1396119,42785235300
503,영원무역홀딩스,37150,36600,-550,-1.48,48866,1846851200
504,영진약품,7560,7070,-490,-6.48,12705581,95655642780
505,영풍,500000,500000,0,0.0,10203,5125475000
506,영풍제지,3405,3400,-5,-0.15,342856,1196369580
507,영화금속,1635,1680,45,2.75,9019942,15142319590
508,영흥,1120,1110,-10,-0.89,1471849,1638910050
509,예스코홀딩스,35650,34950,-700,-1.96,8510,304058100
510,오뚜기,562000,554000,-8000,-1.42,17790,9946339000
511,오리엔트바이오,1610,1430,-180,-11.18,12408179,18846030430
512,오리온,128500,116000,-12500,-9.73,515522,63157521976
513,오리온홀딩스,12300,12700,400,3.25,1542084,19741237500
514,용평리조트,4220,3990,-230,-5.45,423588,1730272485
515,우리금융지주,8600,8830,230,2.67,15324093,136360727100
516,우리들휴브레인,3880,3995,115,2.96,15255291,58299565985
517,우리종금,515,507,-8,-1.55,9590332,4986635961
518,우신시스템,3235,3215,-20,-0.62,5421161,18647920000
519,우진,4400,4565,165,3.75,48581217,243903054775
520,우진아이엔에스,7700,7560,-140,-1.82,77468,588613210
521,우진플라임,4340,4050,-290,-6.68,312966,1311752430
522,웅진,1065,1030,-35,-3.29,498233,520629825
523,웅진씽크빅,2555,2560,5,0.2,1578058,4069853335
524,원림,18100,18000,-100,-0.55,7999,147426550
525,웰바이오텍,2125,2045,-80,-3.76,1173177,2482185985
526,윌비스,1300,1175,-125,-9.62,34259930,46045884010
527,유나이티드제약,49750,46000,-3750,-7.54,4017374,192139321850
528,유니드,45700,44700,-1000,-2.19,139403,6289641900
529,유니온,7370,6830,-540,-7.33,2059178,14727598560
530,유니온머티리얼,4280,4280,0,0.0,45581178,198359854000
531,유니켐,1350,1305,-45,-3.33,1177341,1565617970
532,유니퀘스트,10000,9710,-290,-2.9,3502355,35897434680
533,유성기업,2685,2710,25,0.93,1208168,3260713130
534,유수홀딩스,5370,5200,-170,-3.17,110154,585032800
535,유안타증권,2765,2735,-30,-1.08,2011272,5705784835
536,유안타증권우,2230,2265,35,1.57,9523468,24090503355
537,유엔젤,4445,4125,-320,-7.2,1483396,6489182860
538,유유제약,14500,13100,-1400,-9.66,885288,12222345000
539,유유제약1우,14750,13950,-800,-5.42,484979,7404734650
540,유유제약2우B,34200,36050,1850,5.41,43165,1573310000
541,유진투자증권,3715,3675,-40,-1.08,3591765,13643969660
542,유한양행,61700,57900,-3800,-6.16,1579920,94401755100
543,유한양행우,61500,58800,-2700,-4.39,31736,1915228000
544,유화증권,2260,2265,5,0.22,85023,191967820
545,유화증권우,2370,2380,10,0.42,70604,170912035
546,율촌화학,15350,15450,100,0.65,224012,3467342450
547,이건산업,8370,7960,-410,-4.9,2206500,18599015570
548,이구산업,1675,1565,-110,-6.57,45033127,85372407425
549,이노션,56100,59800,3700,6.6,431311,25055587200
550,이리츠코크렙,5560,5840,280,5.04,437734,2508028370
551,이마트,154500,148000,-6500,-4.21,1235776,187112751500
552,이수페타시스,4060,3940,-120,-2.96,2261232,9124509730
553,이수화학,10950,10300,-650,-5.94,4699899,51464241350
554,이스타코,647,601,-46,-7.11,760062,469432728
555,이아이디,260,245,-15,-5.77,34901170,8707918981
556,이엔플러스,3950,3600,-350,-8.86,1659239,6299946970
557,이연제약,20600,18650,-1950,-9.47,738425,14710168400
558,이월드,3215,2970,-245,-7.62,1865773,5833912485
559,이지스레지던스리츠,5000,5070,70,1.4,934073,4702593160
560,이지스밸류리츠,4960,4985,25,0.5,1097597,5462258810
561,이화산업,14450,14800,350,2.42,65844,1047066750
562,인디에프,1670,1580,-90,-5.39,1310599,2155114030
563,인스코비,2550,2320,-230,-9.02,7709585,19241291855
564,인지컨트롤스,11350,10150,-1200,-10.57,5014002,54354853480
565,인천도시가스,26000,25650,-350,-1.35,10334,266914950
566,인터지스,2595,2370,-225,-8.67,1625873,3954361150
567,인팩,4895,4685,-210,-4.29,106829,497268715
568,일동제약,15350,16000,650,4.23,1144743,18510164150
569,일동홀딩스,8850,9070,220,2.49,96801,872462010
570,일성건설,922,890,-32,-3.47,628095,567971526
571,일성신약,78000,78900,900,1.15,130309,11049225000
572,일신방직,67900,68200,300,0.44,36836,2516392400
573,일신석재,2070,1985,-85,-4.11,3041132,6169074375
574,일양약품,72000,70400,-1600,-2.22,2634457,193186482300
575,일양약품우,90000,86000,-4000,-4.44,34500,3051943300
576,일정실업,13850,18000,4150,29.96,565309,11724942000
577,일진다이아,49200,44600,-4600,-9.35,1358526,64041237000
578,일진디스플,4020,3700,-320,-7.96,732356,2820287510
579,일진머티리얼즈,41050,41900,850,2.07,2892533,125161277000
580,일진전기,2945,2720,-225,-7.64,581735,1653486630
581,일진홀딩스,4680,4700,20,0.43,936070,4443000960
582,잇츠한불,28300,30000,1700,6.01,3457422,102876272650
583,자이에스앤디,7960,8110,150,1.88,1045236,8485549110
584,자화전자,14600,12750,-1850,-12.67,1688023,23093358650
585,전방,32650,28300,-4350,-13.32,830245,27564688200
586,제이알글로벌리츠,5080,5200,120,2.36,1425350,7361139310
587,제이에스코퍼레이션,6950,6690,-260,-3.74,115733,794746110
588,제이준코스메틱,2545,2525,-20,-0.79,742988,1889165110
589,제이콘텐트리,25850,25700,-150,-0.58,436968,11041754000
590,제일기획,21500,20550,-950,-4.42,1765314,37511494650
591,제일약품,47650,47050,-600,-1.26,7638719,361858615650
592,제일연마,6690,6700,10,0.15,63326,424888530
593,제일파마홀딩스,21150,20300,-850,-4.02,1242345,25886999450
594,제주은행,3135,3230,95,3.03,329575,1062589805
595,제주항공,13800,13300,-500,-3.62,857891,11652316000
596,조광페인트,4975,4995,20,0.4,38945,194715460
597,조광피혁,49550,49400,-150,-0.3,12742,627340500
598,조비,19150,17150,-2000,-10.44,205934,3696814850
599,조선내화,73600,74200,600,0.82,7336,540997000
600,조선선재,101000,102000,1000,0.99,86591,8926403000
601,조일알미늄,729,670,-59,-8.09,10897195,8204761440
602,조흥,149000,155000,6000,4.03,647,98877000
603,종근당,166500,153000,-13500,-8.11,314705,50493491000
604,종근당바이오,42600,39600,-3000,-7.04,351975,14237161650
605,종근당홀딩스,102500,98800,-3700,-3.61,131420,13249504600
606,주연테크,1095,1050,-45,-4.11,18208490,21675346680
607,지누스,80800,79600,-1200,-1.49,246775,20018506800
608,지엠비코리아,7850,7110,-740,-9.43,1804481,13382341870
609,지역난방공사,39600,36750,-2850,-7.2,206766,8037235700
610,지코,306,306,0,0.0,0,0
611,지투알,5250,5220,-30,-0.57,112455,583797340
612,진도,2685,3030,345,12.85,8739049,28606700580
613,진양산업,4550,3915,-635,-13.96,14204626,67809427725
614,진양폴리,3815,3250,-565,-14.81,1664767,6282847585
615,진양홀딩스,2735,2650,-85,-3.11,593832,1606334475
616,진양화학,5090,4145,-945,-18.57,3455269,16579933140
617,진에어,9100,8590,-510,-5.6,471581,4190076590
618,진원생명과학,28600,24600,-4000,-13.99,17921798,474150527700
619,진흥기업,2350,2320,-30,-1.28,3216817,7708559145
620,진흥기업2우B,14250,13650,-600,-4.21,41110,576895550
621,진흥기업우B,12250,10900,-1350,-11.02,3569520,44440126650
622,참엔지니어링,1370,1300,-70,-5.11,1009468,1362907725
623,천일고속,67700,67400,-300,-0.44,12315,836974600
624,체시스,2980,3150,170,5.7,11000007,33242915470
625,카카오,353000,334000,-19000,-5.38,3802559,1300982401000
626,카프로,2460,2505,45,1.83,671944,1690183330
627,컨버즈,4100,4100,0,0.0,0,0
628,케이비아이동국실업,629,611,-18,-2.86,483061,298833398
629,케이씨,24750,23850,-900,-3.64,674245,16286986800
630,케이씨텍,23500,20700,-2800,-11.91,1128731,24797805150
631,케이탑리츠,817,808,-9,-1.1,906341,734404302
632,코람코에너지리츠,4910,4945,35,0.71,1360901,6705501240
633,코리아써우,4890,4920,30,0.61,7114,34733035
634,코리아써키트,13500,12400,-1100,-8.15,914570,11975231900
635,코리아써키트2우B,6500,6530,30,0.46,22449,147949270
636,코리안리,7660,7590,-70,-0.91,1820581,14181763400
637,코스맥스,122500,112000,-10500,-8.57,391030,46176322500
638,코스맥스비티아이,18800,17300,-1500,-7.98,93845,1672146500
639,코스모신소재,13950,12950,-1000,-7.17,1617650,21942453100
640,코스모화학,8600,7660,-940,-10.93,1658783,13400978950
641,코아스,1090,1065,-25,-2.29,1510974,1645071035
642,코오롱,21000,20050,-950,-4.52,186729,3804400750
643,코오롱글로벌,18700,17000,-1700,-9.09,584666,10450101250
644,코오롱글로벌우,36350,31150,-5200,-14.31,51938,1739277800
645,코오롱우,15350,15400,50,0.33,19150,292758300
646,코오롱인더,37650,36600,-1050,-2.79,716443,26466576550
647,코오롱인더우,20500,20050,-450,-2.2,63709,1289076450
648,코오롱플라스틱,4040,3900,-140,-3.47,418551,1665381830
649,코웨이,78800,72300,-6500,-8.25,1213831,91204310324
650,콤텍시스템,1560,1570,10,0.64,36284484,60823707780
651,쿠쿠홀딩스,99300,94700,-4600,-4.63,40512,3948661100
652,쿠쿠홈시스,40800,39800,-1000,-2.45,151830,6144454000
653,큐로,602,597,-5,-0.83,6370874,3794681315
654,크라운제과,8610,8440,-170,-1.97,100699,863346720
655,크라운제과우,10600,12550,1950,18.4,4474168,60976004300
656,크라운해태홀딩스,8900,8840,-60,-0.67,175100,1579222510
657,크라운해태홀딩스우,13500,17400,3900,28.89,2612274,44047132800
658,키다리스튜디오,8680,8170,-510,-5.88,787881,6315154160
659,키움증권,95500,103500,8000,8.38,696765,71452179894
660,태경비케이,3555,3480,-75,-2.11,952483,3360129455
661,태경산업,5030,4995,-35,-0.7,208060,1042505670
662,태경케미컬,8110,8030,-80,-0.99,1658145,13992773700
663,태광산업,669000,691000,22000,3.29,7345,4964192000
664,태림포장,5170,5250,80,1.55,90220888,478387069640
665,태양금속,1010,1000,-10,-0.99,1217473,1233862027
666,태양금속우,3615,3840,225,6.22,4186319,16680498000
667,태영건설,9330,10550,1220,13.08,2512354,25160852780
668,태영건설우,15850,15450,-400,-2.52,1590831,25925452750
669,태원물산,4015,3795,-220,-5.48,215774,831934850
670,태평양물산,1630,1575,-55,-3.37,815780,1312626545
671,테이팩스,30450,27650,-2800,-9.2,271321,8040605400
672,텔코웨어,11900,11600,-300,-2.52,40296,473947250
673,토니모리,9720,9310,-410,-4.22,168824,1620431600
674,티에이치엔,2300,2225,-75,-3.26,347997,785871630
675,티와이홀딩스,21200,21600,400,1.89,1643170,36554625600
676,티와이홀딩스우,29650,26700,-2950,-9.95,350567,10136829200
677,티웨이항공,2585,2240,-345,-13.35,886992,2131709725
678,티웨이홀딩스,927,890,-37,-3.99,597054,543216983
679,파미셀,15600,16200,600,3.85,37289839,696316475450
680,팜스코,4740,4595,-145,-3.06,511053,2435778035
681,팬오션,3600,3735,135,3.75,12623265,47209811400
682,퍼스텍,2055,2010,-45,-2.19,1074523,2179956365
683,퍼시스,28600,29300,700,2.45,7069,204980500
684,페이퍼코리아,1800,1665,-135,-7.5,697337,1203492605
685,평화산업,1135,1105,-30,-2.64,699735,782144765
686,평화홀딩스,3275,3170,-105,-3.21,138518,453332170
687,포스코강판,15300,14850,-450,-2.94,827615,12873262950
688,포스코인터내셔널,14600,13650,-950,-6.51,3563621,52111713150
689,포스코케미칼,77300,73000,-4300,-5.56,1700372,127554399500
690,풀무원,16850,15650,-1200,-7.12,340681,5449752250
691,풍산,26450,25800,-650,-2.46,3821584,102480861300
692,풍산홀딩스,25750,26500,750,2.91,107676,2929047450
693,하나금융지주,29950,31100,1150,3.84,14719380,467432410158
694,하나제약,23450,22850,-600,-2.56,297698,6939020600
695,하나투어,41100,40200,-900,-2.19,522710,21299009400
696,하이골드3호,1330,1335,5,0.38,92137,122799490
697,하이스틸,16250,15450,-800,-4.92,17062,271212350
698,하이트론,2555,2560,5,0.2,179891,467927000
699,하이트진로,37500,33750,-3750,-10.0,2015785,71015828950
700,하이트진로2우B,21950,20650,-1300,-5.92,16421,344124400
701,하이트진로홀딩스,16800,15150,-1650,-9.82,173683,2747494500
702,하이트진로홀딩스우,15800,14850,-950,-6.01,5152,79713000
703,한국ANKOR유전,1645,1665,20,1.22,22337,36907280
704,한국가스공사,31450,29400,-2050,-6.52,6692070,205994562850
705,한국공항,30750,30000,-750,-2.44,35648,1086393650
706,한국금융지주,67800,70700,2900,4.28,2355449,167720451200
707,한국금융지주우,57600,57800,200,0.35,283968,16816351800
708,한국내화,3245,3170,-75,-2.31,343540,1106476655
709,한국단자,47700,46650,-1050,-2.2,131338,6162853150
710,한국석유,94600,90200,-4400,-4.65,9162,841747400
711,한국수출포장,19100,18800,-300,-1.57,88662,1673507400
712,한국쉘석유,239500,240000,500,0.21,10359,2490396500
713,한국자산신탁,3870,3740,-130,-3.36,3819269,15001573105
714,한국전력,21400,20600,-800,-3.74,16378606,347031902800
715,한국전자홀딩스,1025,803,-222,-21.66,31727774,29109999698
716,한국조선해양,80600,80800,200,0.25,951509,77434623800
717,한국종합기술,4235,4020,-215,-5.08,238167,977102365
718,한국주강,1615,1470,-145,-8.98,1209019,1843681600
719,한국주철관,8290,8200,-90,-1.09,581363,4809336060
720,한국철강,4750,4705,-45,-0.95,494772,2388161380
721,한국카본,9700,9500,-200,-2.06,19791282,208059840210
722,한국콜마,47200,45000,-2200,-4.66,591681,27403047800
723,한국콜마홀딩스,26050,24450,-1600,-6.14,311296,7882588000
724,한국타이어앤테크놀로지,32900,33200,300,0.91,1552304,51717334800
725,한국토지신탁,1805,1835,30,1.66,6968920,12938482150
726,한국패러랠,1930,1925,-5,-0.26,124220,238811210
727,한국프랜지,2090,2010,-80,-3.83,1113398,2309910595
728,한국항공우주,22600,22400,-200,-0.88,1495730,34065212150
729,한국화장품,13050,13000,-50,-0.38,1277435,16952675250
730,한국화장품제조,39150,38900,-250,-0.64,263233,10497560950
731,한농화성,8800,7440,-1360,-15.45,1931039,15641821210
732,한독,31300,28750,-2550,-8.15,616929,18336749900
733,한라,3315,3410,95,2.87,833945,2820490535
734,한라홀딩스,32050,32350,300,0.94,269632,8636082700
735,한미글로벌,9050,8540,-510,-5.64,990898,8571637490
736,한미반도체,11400,10100,-1300,-11.4,3044984,32483136560
737,한미사이언스,59900,57200,-2700,-4.51,1323551,78609190300
738,한미약품,278500,271000,-7500,-2.69,263587,72319624000
739,한샘,98400,99300,900,0.91,436913,44475550000
740,한섬,30350,28100,-2250,-7.41,524419,15392124000
741,한성기업,11850,11050,-800,-6.75,1793847,21671106500
742,한세실업,18850,17550,-1300,-6.9,3958187,78099613100
743,한세엠케이,2865,2820,-45,-1.57,147678,421052060
744,한세예스24홀딩스,5730,5690,-40,-0.7,859683,5127771650
745,한솔PNS,1530,1440,-90,-5.88,830660,1255526380
746,한솔로지스틱스,2040,1910,-130,-6.37,3845945,7991121235
747,한솔제지,14050,14050,0,0.0,1116741,15928081250
748,한솔케미칼,145500,140000,-5500,-3.78,267475,39065962092
749,한솔테크닉스,9480,9260,-220,-2.32,2005988,18796828870
750,한솔홀딩스,3390,3420,30,0.88,867879,3007107170
751,한솔홈데코,2135,1910,-225,-10.54,230114901,475951504370
752,한신공영,13550,13400,-150,-1.11,216232,2954846900
753,한신기계,1650,1545,-105,-6.36,1999839,3246441115
754,한양증권,8590,8900,310,3.61,606872,5451996910
755,한양증권우,15750,20350,4600,29.21,2282868,60219577400
756,한온시스템,12250,11950,-300,-2.45,3153168,38251661050
757,한올바이오파마,31500,28600,-2900,-9.21,1618581,48526039600
758,한익스프레스,5100,5050,-50,-0.98,1002257,5193308405
759,한일시멘트,83200,80300,-2900,-3.49,22105,1805572100
760,한일철강,1640,1680,40,2.44,111432,187131135
761,한일현대시멘트,25950,24400,-1550,-5.97,61387,1550759450
762,한일홀딩스,47000,44950,-2050,-4.36,24287,1126023050
763,한전KPS,27850,27950,100,0.36,855563,24057627650
764,한전기술,16950,15950,-1000,-5.9,982655,16207545050
765,한전산업,3685,3645,-40,-1.09,336391,1238195715
766,한진,50700,51200,500,0.99,790383,40058690500
767,한진중공업홀딩스,4130,3960,-170,-4.12,365323,1488087275
768,한진칼,78100,78700,600,0.77,652482,51407937000
769,한진칼우,50000,49150,-850,-1.7,58519,2926766800
770,한창,1120,1035,-85,-7.59,6781586,7329636625
771,한창제지,2080,1930,-150,-7.21,4563643,9304882710
772,한화,25150,25450,300,1.19,1506221,38783067650
773,한화3우B,13200,13200,0,0.0,267944,3540747200
774,한화생명,1570,1590,20,1.27,83050640,138867640460
775,한화손해보험,2785,2900,115,4.13,8354975,25113896310
776,한화솔루션,43200,44150,950,2.2,30781905,1372704593450
777,한화솔루션우,71600,72100,500,0.7,1394386,107699839800
778,한화시스템,10700,10700,0,0.0,1707996,18576035250
779,한화에어로스페이스,26000,25950,-50,-0.19,1798550,47527136700
780,한화우,45000,47500,2500,5.56,89468,4629836800
781,한화투자증권,1745,1770,25,1.43,4605130,8333437590
782,한화투자증권우,4500,4365,-135,-3.0,7488465,38624534565
783,해성디에스,19300,17050,-2250,-11.66,1115168,20373611950
784,해태제과식품,8480,8290,-190,-2.24,143542,1214803100
785,핸즈코퍼레이션,6770,6720,-50,-0.74,115517,775949210
786,현대건설,31900,30700,-1200,-3.76,4726134,149772501700
787,현대건설기계,28350,27400,-950,-3.35,1513433,44100651100
788,현대건설우,178000,175000,-3000,-1.69,17524,3307857500
789,현대그린푸드,7580,7430,-150,-1.98,1834703,13979226750
790,현대글로비스,174500,177000,2500,1.43,6553477,1273469262900
791,현대로템,16100,15150,-950,-5.9,5940538,93198292900
792,현대리바트,15600,15050,-550,-3.53,560183,8715163650
793,현대모비스,222500,244500,22000,9.89,4107098,970528107500
794,현대미포조선,28100,29600,1500,5.34,1128055,33123491650
795,현대백화점,66400,61300,-5100,-7.68,1640051,107609983900
796,현대비앤지스틸,7750,7610,-140,-1.81,596746,4653764600
797,현대비앤지스틸우,71300,69800,-1500,-2.1,4433,314899700
798,현대약품,6620,5900,-720,-10.88,8620614,53703942100
799,현대에너지솔루션,33250,33200,-50,-0.15,1221864,41887618000
800,현대엘리베이,40100,38000,-2100,-5.24,932604,36528899050
801,현대오토에버,62900,63300,400,0.64,1609854,105762602100
802,현대위아,41350,42950,1600,3.87,1364342,57920343200
803,현대일렉트릭,14100,14050,-50,-0.35,1832860,26368271950
804,현대제철,30600,29850,-750,-2.45,10929877,340466586900
805,현대중공업지주,223500,222500,-1000,-0.45,166604,37464718000
806,현대차,168000,172500,4500,2.68,17378586,2896755570500
807,현대차2우B,83900,84600,700,0.83,606582,49853133700
808,현대차3우B,78100,77500,-600,-0.77,179141,13618863700
809,현대차우,81100,81600,500,0.62,662181,52257923100
810,현대차증권,10350,11200,850,8.21,2701928,30188383250
811,현대코퍼레이션홀딩스,10900,10950,50,0.46,220572,2446906650
812,현대해상,23850,24850,1000,4.19,2236575,56234453250
813,현대홈쇼핑,74200,71900,-2300,-3.1,268346,19987582600
814,형지엘리트,1910,2055,145,7.59,16982206,37180856435
815,혜인,5300,4950,-350,-6.6,1336594,7075687285
816,호전실업,7780,7800,20,0.26,370438,2945931430
817,호텔신라,77200,75300,-1900,-2.46,3455675,267454230900
818,호텔신라우,66700,79300,12600,18.89,1420261,122898129100
819,화성산업,12950,12150,-800,-6.18,1918810,24814748900
820,화승알앤에이,2050,1940,-110,-5.37,938869,1867645495
821,화승엔터프라이즈,14350,13300,-1050,-7.32,1211928,17386501300
822,화승인더,7700,7210,-490,-6.36,1697398,12838006430
823,화신,2750,2920,170,6.18,1308346,3636338110
824,화인베스틸,2350,2325,-25,-1.06,1885225,4373339375
825,화천기계,2895,2610,-285,-9.84,835882,2296654540
826,화천기공,30650,30700,50,0.16,11048,339088800
827,환인제약,14800,14350,-450,-3.04,337874,4922740150
828,황금에스티,6860,6760,-100,-1.46,634818,4448780100
829,효성,77000,74900,-2100,-2.73,328022,25210078100
830,효성ITX,23500,20850,-2650,-11.28,170385,3770657850
831,효성중공업,59800,55400,-4400,-7.36,801683,46388337800
832,효성첨단소재,133500,123500,-10000,-7.49,215167,27599667000
833,효성티앤씨,144000,141500,-2500,-1.74,261635,38310914500
834,효성화학,129500,129500,0,0.0,133475,17600726500
835,후성,9230,8490,-740,-8.02,6655698,59324158950
836,휠라홀딩스,38750,39100,350,0.9,3308246,135115480000
837,휴니드,5760,5560,-200,-3.47,488589,2763538650
838,휴비스,8100,7990,-110,-1.36,1901822,15573423030
839,휴스틸,6940,6780,-160,-2.31,70766,491262490
840,휴켐스,23000,23700,700,3.04,1470485,34190504000
841,흥국화재,2870,2810,-60,-2.09,1961692,5732160825
842,흥국화재2우B,28000,23800,-4200,-15.0,55085,1517605950
843,흥국화재우,18900,16600,-2300,-12.17,8215143,181870083800
844,흥아해운,258,258,0,0.0,0,0
